18 17
#o###############
#@#...........#.#
#.#########G#.#.#
#.........#.#.#.#
#########.#.#.#.#
#w#.....#...#...#
#.#.#.#.#######.#
#i..#.#.#.......#
#.###.#.#.#######
#..w#.#.#.....#.#
###.#.#.#####.#.#
#...#.#.#S#...#.#
#.###.#.#.#.###.#
#.#...#G.k#.....#
#.#.###########.#
#J#.............#
############c####
