18 17
#o###############
#.#...........#.#
#.#########.#.#.#
#.........#.#.#.#
#########.#.#.#.#
#.#.....#...#...#
#.#.#.#.#######.#
#...#.#.#.......#
#.###.#.#.#######
#...#.#.#.....#.#
###.#.#.#####.#.#
#...#.#.#.#...#.#
#.###.#.#.#.###.#
#.#...#...#.....#
#.#.###########.#
#.#....@k.......#
############c####