25 20
#############
#...........#    ########
#...........######......#
#.......................#
#...........######......#
#...........#    #......#
#...........#    #......#
#...........#    #......#
#####..######    ###..###
    #..#           #..#
    #..#           #..#
    #..#          ##..##
  ###..####      #......#
  #.......#      #......#
  #.......#      #......#
  #.......#      #......#
  #.......#      #......#
  #.......#      #......#
  #...@...#      #......#
  ####o####       ######
