23 16
########################
########################
##--------.b.---------##
##...a.---...----.a...##
##........---.........##
##.........a..........##
##....................##
##....................##
##....................##
##....................##
##....................##
##................i...##
##........w@s.........##
##....................##
########################
########################

