23 16
########################
########################
##--------.b.---------##
##...l.---...----.l...##
##........---.........##
##.........l..........##
##....................##
##....................##
##....................##
##....................##
##....................##
##....................##
##.......wX@s.........##
##....................##
########################
########################




