18 17
#################
#@#...........#.#
#.#########G#.#.#
#.........#.#.#.#
#########.#.#.#.#
#.#.....#...#...#
#.#.#.#.#######.#
#i..#.#.#.......#
#.###.#.#.#######
#..w#.#.#.....#.#
###.#.#.#####.#.#
#...#.#.#k#...#.#
#.###.#.#.#.###.#
#.#...#G..#.....#
#.#.###########.#
#J#.............#
############c####
