21 14
w#####################
#--------.b.---------#
#...a.---...----.a...#
#........---.........#
#.........a..........#
#....................#
#....................#
#....................#
#....................#
#....................#
#....................#
#........w@s.........#
#....................#
######################

